00000000100000000000000000000000
00000001111000000000000000000000
00001111111110000000000000000000
00011111111111000000000000000000
00011111111111000000000000000000
00001111111110000000000000000000
00000011111000000000000000000000
00000000100000000000000000000000
00000000100000000000001110000000
00000011111100000000001110000000
00001111111111100000001110000000
00011111111111111000000100000111
01111111111111111111111111111111
11111110000111111111111111000111
11111100000011111111111111000000
01111110000111111111111110000000
11111111111111111111110000000000
00001111111111111100000000000000
00000001111100000000000001110000
00000000100000000000000001110000
00000011100000000000000001110000
00000011100000000000000000100000
00000011111110000000000011111100
00011111100010000000011111111100
00111000001110000011111111111000
01111000000000001111100000000000
00110000001111111100000000000000
01111111111111100000000000000000
01111111111000000000000000000000
00111000000000000000000000000000
00111110000000000000000000000000
01111100000000000000000000000000