0,0,0,0,0,1,0,0,0,0,0,0
0,0,0,0,0,1,1,1,0,0,0,0
1,1,1,2,0,1,0,1,0,0,0,0
0,0,0,1,0,1,1,3,0,0,1,1
0,4,1,1,1,1,0,0,0,0,1,0
0,0,0,1,0,1,0,0,0,0,1,0
0,0,0,1,0,1,1,1,5,0,1,0
0,0,0,6,1,1,0,0,0,0,8,0
0,0,0,0,0,1,0,0,0,0,1,0
0,0,0,0,0,1,1,7,1,1,1,0
1,9,1,1,1,1,0,0,0,0,0,0
0,0,0,0,0,1,0,0,0,0,0,0